111111
10CE01
1P0001
111111
100001
100001
100001
111111
