111111111111111111111111111111111111111111111111111111
111111111111111111111111111111111111111111111111111111
110000000000000110000000000000000000011000000000000011
110000000000000110000000000000000000011000000000000011
110000P00000000110000000000000000000011000000000000011
110000000000000110000000111100000000011000000000000011
110000000000000110000000111100000000011000000000000011
111111000011111110000000111100000000011000000000000011
111111100111111110000000111100000000011000000000000011
110000000000000000000000000000000000011000000000000011
110000000000000000000000000000000000011000000000000011
110000000000000000000000000000000000011000000000000011
110000000000000000000000000000000000011000000000000011
111111111111111111111111100000000000011000000000000011
1111111111111111111111111000000000000110000C0000000011
110000000000000000000000000000000000000000000000000011
110000000000000000000000000000000000000000000000000011
110000000000000000000011111111111111111111111111110011
110000000000000000000011111111111111111111111111110011
110000000000000000000011000000000000000000000000110011
11000000000000000000001100000000000000000000E000110011
110000000000000000000011000011000000000000000000110011
110000000000000000000011000011000000000000000000110011
110000000000000000000011000011111111111111111111110011
110000000000000000000011000011111111111111111111110011
110000000000000000000011000000000000000000000000000011
110000000000000000000011000000000000000000000000000011
110000000000000000000011000000000000000000000000000011
111111111111111111111111111111111111111111111111111111
111111111111111111111111111111111111111111111111111111
