111111111111111111111111111111111111111111111111111111
111111111111111111111111111111111111111111111111111111
110000000000000110000000000000000000011000000000000011
110000000000000110000000000000000000011000000000000011
110000P0C00N000110000000000000000000011000000000000011
110000000000000110000000111100000000011000000000000011
110000000000000110000000111100000000011000000000000011
111111000011111110000000111100000000011000000000000011
111111100111111110000000111100000000011000000000000011
110000000000000110000000000000000000011000000000000011
110000000000000110000000000000000000011000000000000011
110000000000000110000000000000000000011000000000000011
110000000000000110000000000000000000011000000000000011
110011111111111111111111100000000000011000000000000011
110011111111111111111111100000001100011000000000000011
1100110000000000000000000000000011000M0000000000000011
110011000000000000000000000000001100000000000000000011
110011000000000000000011111111111111111111111111110011
1100110000000000000000111111111111111111111E0111110011
110011000000000000000011000000000000000000100100110011
110011000000000000000011000000000000000000000000110011
110011000000000000000011000011000000000000000000110011
110011000000000000000011000011000000000000000000110011
110011000000000000000011000011111111111111111111110011
110011000000000000000011000011111111111111111111110011
110011000000000000000011000000000000000000000000000011
110000000000000000000011000000000000000000000000000011
110000000000000000000011000000000000000000000000000011
111111111111111111111111111111111111111111111111111111
111111111111111111111111111111111111111111111111111111
