111111111111111111111111111111111111111111111111111111111111
111111111111111111111111111111111111111111111111111111111111
110000000000000000110000000000000000000000000000000000000011
110000000000000000110000000000000000000000000000000000000011
110000P00000000000110000000000000000000000000000000000000011
110000000000000000110000000000000000000000000000000000000011
110000000000000000110000000000000000000000000000000000000011
111111000011111111110000000000000000000000000000000000000011
111111100111111111110000000000000000000000000000000000000011
110000000000000000000000000000000000000000000000000000000011
110000000000000000000000000000000000000000000000000000000011
110000000000000000000000000000000000000000000000000000000011
110000000000000000000000000000000000000000000000000000000011
110000000000000000000000000000000000000000000000000000000011
1100000000000000000000000000000000000000000000C0000000000011
110000000000000000000000000000000000000000000000000000000011
110000000000000000000000000000000000000000000000000000000011
110000000000000000000000000000000000000000000000000000000011
110000000000000000000000000000000000000000000000000000000011
1100000000000C0000000000011111111111111111111111111110000011
110000000000000000000000011111111111111111111111111110000011
110000000000000000000000011000000000000000000000000110000011
11000000000000000000000001100000000000000000000E000110000011
110000000000000000000000011000011000000000000000000110000011
110000000000000000000000011000011000000000000000000110000011
110000000000000000000000011000011111111111111111111110000011
110000000000000000000000011000011111111111111111111110000011
110000000000000000000000011000000000000000000000000000000011
110000000000000000000000011000000000000000000000000000000011
110000000000000000000000011000000000000000000000000000000011
111111111111111111111111111111111111111111111111111111111111
111111111111111111111111111111111111111111111111111111111111
